###############
#.P...#K...D.P#
#....E#..P.#..#
#...########..#
#...#...D..#.K#
#...#P.K#..#.##
#..######..#..#
#D##K#........#
#.#..#........U
#.#..#.....#.##
#...P#.....#.K#
#..###...######
#...#....#...P#
#P..D....D.P..#
###############