#PPP##GGG#
#....#....
#....#....
E....#...U
GP####....
#....#...#
#....#.###
#....#.###
#....#...#
####...###
