###############
#...#G...##...#
#.#.####..###.#
#.#.##.##..P..#
#.#D##.###.##K#
#G#....###...##
######.....#..E
#...K#.#.######
###.##.#......#
#...##.P.#.#.##
#.##.#.#.#.####
#...P#.#.#..K##
###.##.#.######
#....D.#.D...G#
#U#############