##########
#.#.G...G#
#P####D#.#
#.#....#P#
#U#....#.#
#.####.###
#.##.....#
#.##.P.#G#
#E.....#K#
##########
